10101010101010101010
11111111111111111111
12121212121212121212
13131313131313131313
14141414141414141414
15151515151515151515
16161616161616161616
17171717171717171717
18181818181818181818
19191919191919191919
0
