10000010000014141400
10001000001400000014
10100000001400000000
10001000001400000014
10000010000014141400
00141414001818181818
14000000140000180000
14000000000000180000
14000000140000180000
00141414000000180000
0
