10001800100018001000
00180010001800100018
18001000180010001800
00100018001000180010
10001800100018001000
00180010001800100018
18001000180010001800
00100018001000180010
10001800100018001000
00180010001800100018
0
