14000000000000000014
00000000000000000000
00000000000000000000
00000000000000000000
00000000141400000000
00000000141400000000
00000000000000000000
00000000000000000000
00000000000000000000
14000000000000000014
0
