18180000101000001818
18000010000010000018
00001000000000100000
00100000141400001000
10000014000014000010
10000014000014000010
00100000141400001000
00001000000000100000
18000010000010000018
18180000101000001818
0
