00001000141400100000
00100010000010001000
10000000181800000010
00100018000018001000
14001800141400180014
14001800141400180014
00100018000018001000
10000000181800000010
00100010000010001000
00001000141400100000
0
