10101010101010101010
10111111111111111110
10111212121212121110
10111213131313121110
10111213141413121110
10111213141413121110
10111213131313121110
10111212121212121110
10111111111111111110
10101010101010101010
9034
